11111111111
10000000001
11111000111
11110000001

11111111111
