
NO ./path/to/north_texture.xpm
	SO			./path/to/south_texture.xpm
WE ./path/to/west_texture.xpm     	


	11111111
10001
	1N0001
111111

EA	  	   	./path/to/east_texture.xpm

F 240,200,1

C222,222,222

